
NO 999_1.xpm
SO 999_2.xpm
WE 999_3.xpm
EA 999_4.xpm

F 220, 111, 123
C 225,111,200

 11111111111111111111111111111111111111
1000000000000000000000000000000000000001
1000000000000000000000000000000000000001
100000000000N000000000000000000000000001
1000000000000000001010000000000000000001
1000000000000000001010000000000000000001
1000000000000000001010010000000000000001
1000000000000000000000000000000000000001
1000000000000000000010000000000000000001
1000000000000000000000000000000000000001
1000000000000000000000000000000000000001
1000000000000000000000000000000000000001
 11111111111111111111111111111111111111


